0100000000011101111111110
0101111111010001000000010
0101000000010111011111110
0101110111110100000000010
0100010000010101111101010
0101011111110100010001010
0101000000010111110111010
0101111111010100000100010
0001000101010101111101110
0111010101010001000000010
0000010001011111111111111
111111111111000000000000

