111111111111111
100000000010001
111111111011101
100000001010001
111111101010101
100000101010101
101110101010101
100010001000101
101011101111101
101010001000101
101011111110101
101000100010001
101110101010111
100010001000001
111111111111111
