111111111111111
100010000010001
111010101010101
100010101010101
101111101011101
100010001000001
111010111111111
100010100000001
101110101110101
101000100010101
101011111010101
101000000010101
101111111110101
100000000000101
111111111111111
