111111111111111
101000100000001
101010101111101
100010100010001
111110111010111
101000100010101
101011101110101
101010001000101
101010111011101
100010001000001
101110101111101
100010101000101
111011101010101
100000001010001
111111111111111
