111111111111111
101000001000001
101110101011101
100010100000101
111011111111101
101000100000001
101110101011111
101000101000001
101011101110101
100000100010101
111110111110101
100000100000101
101111101111101
100000001000001
111111111111111
