1111111111111111111111111
1010000000100010000000001
1010111010111010111111101
1010001010001000000010001
1011101111101011111110111
1000101000101010000010001
1110101010101110111011101
1010001010100010001000001
1011111011111011101111111
1010001000101000000010001
1010111010101111101010101
100000001000000000100010

