1111111111111111111111111
1000000010100010000000101
1111111010101010111110101
1000100010101000000010001
1011101110101111111011101
1000100010000010001010101
1010111011111110101010101
1010100010000010100010001
1010101110111010111011111
1010100000101000101010001
1010111111101111101010101
101000000000000000000010

