1111111111111111111111111
1010001000001000000010001
1010101011101110111110101
1010100010001000100000101
1011111110101011101111101
1000000010101010001000101
1111111010101010111110101
1000001000101000000000101
1111101110101111111011101
1000000010101000000010001
1011111110101111111110111
100000000010000000000000

