1111111111111111111111111
1010000000100010000000111
1010111110101010111110111
1000100000101010100000001
1111101111101010111111101
1000101000101000100000101
1011101010101111101110101
1000001010101000101010001
1111101010101010101011111
1000100010100010100010001
1010111110111110111011101
101000000000000000100000

