111111111111111111111111
101000000000001000100000
101110101111111010101110
100010100000000010000010
111011101111111111111110
101000100000001000000000
101110111110111011111110
100010100000100010100010
101010101111101110101010
101000101000101010001010
101111111010101010111010
100000000010001000001000

