1111111111111111111111111
1000101000101000100000001
1110101010101010101011101
1000101010000010101000101
1011101011111011101110111
1000100010001000100010001
1110101110101110111011101
1010101000101000001010001
1010111011101011101110101
1010000010101010100000101
1011111110101010111111101
100000000000001000000000

