1111111111111111111111111
1010000010000010000000001
1011111010101010101111101
1000100010101010101010001
1110101110111011101010111
1000100000100000001010101
1011111111101111111010101
1010000010000010000010101
1010111010111010101110101
1010101010001010100010101
1010101011101010111010101
100010000000101000100000
111111111
